11111111111111111111111111111111
11111111111111111111111166666666
11111111111111114111111151111115
00000500111105000111111451111315
11111511111115111111000050000000
11111511111115111111111151111111
11111511111115111111111151111111
11411511113115111111111151101111
00000500000115111111111151131111
11111511111115111111111151101111
11111511111115111111111151111111
11111511111115111111111151111111
11311511113115111111111151111111
00500000000005000051111151111111
11511111111111111151311151000015
11511111111111111156666651000015
11511131111110111111111151031015
00000000511113111111111151000005
11111111511110111030111151111115
11111111511111111111111151111115
11111111512111111111113151141115
00000000000000000000000000000000