11111111111111111111111111111111
11111111111111111111111111111111
11113111411131111131111411131111
11100000000005111500000000000111
11111111111115111511111111111111
11111111111115111511111111111111
11111115000000000000000511111111
31141135111111111111111531141113
00000005111111313111111500000000
11111115131130000031131511111111
11111115100000000000001511111111
11111115100000111000001511111111
11111115111111111111111511111111
11111315111111131111111513111111
11150000000000000000000000051111
11151111111111121111111111151111
11151311350000000000053113151111
00000000051111111111150000000000
11111111151111111111151111111111
11111111151111111111151111111111
11111111151111111111151111111111