11131111111111111111111111111115
50000051111111111111111111111115
51111151111111111111113111111115
51111151111115000000000005111115
51314151111115111111111115131115
50000051111115111111111115000005
51111156661115111111111115111111
51111151111115111111111115111111
51111156666665666666611145111111
51111151111115111111500000000005
51111151111115111111511111111115
51111151111115113111511111111115
51114151311115000000511111111115
00000000000005111111111111111115
00000011111115111111111150000500
01110011111115111111111151111511
03110011111115111666666651111513
00000000050000000011111151110000
11111111151111111111111151111111
11111111151111111111111151111111
11111111151111112111111151111111