11111111111111111111111111111111
11413111111111111111111111111111
00000000000500000001111111111111
11111111111566666666666111111111
11111111111511110051111111111111
11111111111511410051111113111111
11111111111511110051110000050000
11111111111511110051111111151111
11111111111511110051111111151111
11111111111511110051111111351111
00050000000011110000000050000000
11151111111111111111111151111111
11151111111111111111111151111111
11151111111111111111111151111111
00000000000000500000000051111111
11111111111111511111111151111111
11111111111111511111111151111111
11111111114131566666666651131411
11111150000000001111111100000005
11111151111111111111111111111115
11111151111111111211311111111115