11111111111111111111111111111111
66666666666611111311111111111111
51111111111500000000000005111111
51111111111511111111111115111111
51311111111511111111111115000000
00000051111511111111111115111111
11111151141511111113111115111111
11111150000005000000050000111111
11111151111115111111151111661111
11111151111115111111151111116611
11131151111115111411151111111166
00000501115000000050001111111111
11111511115111111151111111111113
11111566665111111151141111111110
11111511111115000000000051111111
11111511111115000000000051111111
11111511111115000000000051111111
00005000000000011111311000000050
00005000000000015000051000000050
11115111111111115000051111111151
11115111111112115000051111311151